19 20
0 17
00000000000000000S00
01111111111110110100
00000000000010010100
01111111111110111100
00000000000010100000
00000000111111100000
01110110100000000000
01111111111111100000
00000000000000101010
00000000011111101010
E1111111010000001010
00001000010010001010
01111111111111111110
00000000010000000000
00000000010000000000
01111111010111111110
00000001010100000000
01111111111111111110
00000000000000000000